.,Q,Q,Q,Q,Q,.
.,G,B,B,B,B,.
.,G,B,B,B,B,.
.,G,B,B,B,B,.
.,Q,Q,Q,Q,Q,.
.,O,O,O,O,G,.
.,O,O,O,O,G,.
.,O,O,O,O,G,.
.,Q,Q,Q,Q,Q,.