G,Q,G,Q,G,Q,G
.,R,R,R,R,R,.
.,.,B,Q,B,.,.
R,.,.,Q,.,.,R
O,.,.,.,.,.,O
P,P,.,.,.,P,P
P,P,.,.,.,P,P
G,G,G,.,G,G,G
B,B,B,.,B,B,B
P,P,P,.,P,P,P
R,R,R,.,R,R,R
O,O,O,.,O,O,O
G,Q,Q,.,Q,Q,G
