.,.,.,.,.,.,.
.,O,O,O,O,O,.
.,G,G,G,G,G,.
.,B,B,B,B,B,.
.,Q,.,.,.,.,.
.,Q,.,.,.,.,.
.,O,O,O,O,O,.
.,G,G,G,G,G,.
.,B,B,B,B,B,.
