P,P,P,P,P,P,P
R,R,R,R,R,R,R
O,O,.,.,.,O,O
Q,Q,.,.,.,Q,G
Q,O,O,O,O,O,O
Q,O,O,O,O,O,O
Q,G,G,G,.,.,.
Q,P,.,B,B,.,.
Q,P,.,.,B,B,.
Q,P,.,.,.,B,B