.,R,R,R,R,R,.
.,O,O,O,O,O,.
.,G,G,G,G,G,.
.,B,B,B,B,B,.
.,P,P,P,P,P,.
.,R,R,R,R,R,.
.,O,O,O,O,O,.
.,G,G,G,G,G,.
.,B,B,B,B,B,.
.,P,P,P,P,P,.
